{
    "level_number" : 2,
    "level_size" : [10,10],
    "level_array" : [
        [2,2,2,2,2,2,2,2,2,2],
        [2,1,0,0,0,0,0,0,0,2],
        [2,1,0,4,0,0,0,0,0,2],
        [2,2,2,2,2,2,2,0,0,2],
        [0,0,0,0,0,0,2,0,0,2],
        [0,0,0,0,0,0,2,0,0,2],
        [0,0,0,0,0,0,2,0,0,2],
        [0,0,0,0,0,0,2,0,0,2],
        [0,0,0,0,0,0,2,0,3,2],
        [0,0,0,0,0,0,2,2,2,2]
    ]
}