{
    "level_number" : 1,
    "level_size" : [5,10],
    "level_array" : [
        [2,2,2,2,2,2,2,2,2,2],
        [2,1,0,0,0,0,0,0,0,2],
        [2,1,4,0,0,0,0,0,3,2],
        [2,1,0,0,0,0,0,0,0,2],
        [2,2,2,2,2,2,2,2,2,2]
    ]
}